look	look
【ジョージ博士】「どうやらここは1万年ほど前の遺跡であることはわかった」	[Dr. George] "Apparently, we know that this is an archaeological site that is about 10,000 years old."
【ジョージ博士】「だが、まだ文字の解明はできていないのだよ」	[Dr. George] "But we haven't figured out the letters yet."
【ジョージ博士】「ここの石碑にも何か書かれているが全く読めん」	[Dr. George] "There's something written on the monument here, too, but I can't read it at all."
【ジョージ博士】「恐らくは墓のようなものだとは思うのだが……」	[Dr. George] "I know it's probably a tomb, but ......"
end	end
	
switch,1F_Appraisal_2=true	switch,1F_Appraisal_2=true
look	look
【ジョージ博士】「さらに下の階で調査すれば、我々の歴史もわかりそうじゃな」	[Dr. George] "If we investigate further down to the lower level, we might be able to learn more about our history."
feel,Smile	feel,Smile
【ジョージ博士】「年甲斐もなくワクワクしてきたわい！	[Dr. George] "I'm getting excited like a kid again even though I'm not young anymore!"
end	end
	
switch,1F_Appraisal=true	switch,1F_Appraisal=true
look	look
feel,Surprise	feel,Surprise
【ジョージ博士】「なにぃ！？　鑑定のアイテムで文字を読むことができたって！？」	[Dr. George] "What?! You were able to read the text with the appraisal item!?"
【ジョージ博士】「はやく！　はやく何を書いていたか教えてくれ！！　さぁ！！」	[Dr. George] "Quickly! Quickly, tell me what it said! Come on!"
…………	............
……	......
【ジョージ博士】「ほう、なるほど。てっきり弔いの言葉だけが書かれていると思ったら、我々へのメッセージも書いてあったとはな」	[Dr. George] "Oh, I see. I thought it only contained words of condolences, but it also had a message for us."
【ジョージ博士】「この遺跡からは様々な遺物が見つかっているが、もっととんでもないものが眠っているかもしれんな…」	[Dr. George] "Various relics have been found in this ruins, but there may be even more incredible things lying dormant..."
【ジョージ博士】「…………」	[Dr. George] "......"
【ジョージ博士】「その鑑定アイテム、うらやましいのぉ……」	[Dr. George] "I envy that appraisal item..."
set,1F_Appraisal_2,true	set,1F_Appraisal_2,true
end	end