NoControll	NoControll
lookFromCharacter,Fei	lookFromCharacter,Fei
Face,Fei,SMILE	Face,Fei,SMILE
【フェイ】「お、帰ってきた。紹介したいからこっち来てくれ」	【フェイ】「お、帰ってきた。紹介したいからこっち来てくれ」
move,Anchor_10	move,Anchor_10
	
	
AutoMessageTop,true	AutoMessageTop,true
lookFromCharacter,Fei	lookFromCharacter,Fei
lookFromCharacter,Alice	lookFromCharacter,Alice
【フェイ】「コイツは今日ウチの前で倒れていたカイルだ。多分冒険者」	【フェイ】「コイツは今日ウチの前で倒れていたカイルだ。多分冒険者」
【フェイ】「しばらくウチの宿に泊まることになったからよろしくな」	【フェイ】「しばらくウチの宿に泊まることになったからよろしくな」
	
lookFromCharacter,Sol	lookFromCharacter,Sol
【ソル】「俺はソルだ。そこのフェイの幼馴染な」	【ソル】「俺はソルだ。そこのフェイの幼馴染な」
LookCharacterToCharacter,Fei,Sol	LookCharacterToCharacter,Fei,Sol
Face,Fei,OKO	Face,Fei,OKO
【フェイ】「腐れ縁」	【フェイ】「腐れ縁」
【ソル】「長い付き合いってやつな。近くの店で武器屋をやってる」	【ソル】「長い付き合いってやつな。近くの店で武器屋をやってる」
lookFromCharacter,Fei	lookFromCharacter,Fei
Face,Fei,FUN	Face,Fei,FUN
【フェイ】「こんな見た目でこいつ、本業は魔法使いだから」	【フェイ】「こんな見た目でこいつ、本業は魔法使いだから」
【ソル】「見た目は関係ないだろ。魔法がエンチャントされた武器も扱っている。興味があったらウチにくればいい」	【ソル】「見た目は関係ないだろ。魔法がエンチャントされた武器も扱っている。興味があったらウチにくればいい」
【ソル】「趣味はな、筋トレだ！」	【ソル】「趣味はな、筋トレだ！」
【ソル】「カイル、お前はどうだ？ 筋トレはいいぞ！ 武器や魔法より筋肉が大事だと思うだろう？」	【ソル】「カイル、お前はどうだ？ 筋トレはいいぞ！ 武器や魔法より筋肉が大事だと思うだろう？」
LookCharacterToCharacter,Fei,Alice	LookCharacterToCharacter,Fei,Alice
【フェイ】「次、アリス」	【フェイ】「次、アリス」
【ソル】「待て。ここからが大事なところなんだが」	【ソル】「待て。ここからが大事なところなんだが」
【アリス】「…………」	【アリス】「…………」
【アリス】「……アリス。フェイの家族」	【アリス】「……アリス。フェイの家族」
【アリス】「…………」	【アリス】「…………」
【アリス】「……ぬいぐるみはフェルトさん」	【アリス】「……ぬいぐるみはフェルトさん」
【アリス】「…………おわり」	【アリス】「…………おわり」
【フェイ】「アリスはアタシの娘だ。照れてるところもまた可愛いだろ？」	【フェイ】「アリスはアタシの娘だ。照れてるところもまた可愛いだろ？」
【アリス】「……むぅ……」	【アリス】「……むぅ……」
【フェイ】「ごめんって。ま、そんなわけでよろしくだ」	【フェイ】「ごめんって。ま、そんなわけでよろしくだ」
【アリス】「……カイルはどこから来たの？」	【アリス】「……カイルはどこから来たの？」
	
■選択肢	■選択肢
異世界からだ	異世界からだ
覚えてない	覚えてない
	
#isekai	#isekai
【フェイ】「おー、突拍子もないこと言い出したな」	【フェイ】「おー、突拍子もないこと言い出したな」
【アリス】「……異世界……かっこいい……！」	【アリス】「……異世界……かっこいい……！」
【ソル】「違う世界に行きたい。誰もが通る道だ」	【ソル】「違う世界に行きたい。誰もが通る道だ」
【フェイ】「あんたも小さいときに、体に暗黒の力を宿してるとか言ってなかったか？」	【フェイ】「あんたも小さいときに、体に暗黒の力を宿してるとか言ってなかったか？」
【ソル】「俺もその気持ちのまま大人になった。自分には秘められた暗黒の力がある気がしてならない」	【ソル】「俺もその気持ちのまま大人になった。自分には秘められた暗黒の力がある気がしてならない」
【アリス】「……暗黒の力……さすがソル……」	【アリス】「……暗黒の力……さすがソル……」
【フェイ】「アリス、こういう大人たちになっちゃダメだからな」	【フェイ】「アリス、こういう大人たちになっちゃダメだからな」
【アリス】「……えー……」	【アリス】「……えー……」
【ソル】「カイル、言われてるぞ」	【ソル】「カイル、言われてるぞ」
goto,hata_1	goto,hata_1
	
	
#forget	#forget
【ソル】「記憶喪失なのか？ 話には聞いたことがあるが本当にいるんだな」	【ソル】「記憶喪失なのか？ 話には聞いたことがあるが本当にいるんだな」
【アリス】「……衝撃があると思い出すことがあるって、アリス、本で読んだ」	【アリス】「……衝撃があると思い出すことがあるって、アリス、本で読んだ」
【フェイ】「殴ればいいのか？」	【フェイ】「殴ればいいのか？」
【ソル】「待て。それをやったらもう一回忘れる可能性もあるんじゃないか？」	【ソル】「待て。それをやったらもう一回忘れる可能性もあるんじゃないか？」
【アリス】「……え、じゃぁ、もう一回自己紹介しなきゃダメ……？」	【アリス】「……え、じゃぁ、もう一回自己紹介しなきゃダメ……？」
【フェイ】「面倒くさいな。やめておこう」	【フェイ】「面倒くさいな。やめておこう」
goto,hata_1	goto,hata_1
	
#hata_1	#hata_1
■フェードアウト	■フェードアウト
■フェードイン	■フェードイン
…………	…………
……	……
【フェイ】「アリス、そろそろ寝る時間」	【フェイ】「アリス、そろそろ寝る時間」
【アリス】「……はーい……」	【アリス】「……はーい……」
【ソル】「俺もそろそろ帰るか。カイル、今後ともよろしくな」	【ソル】「俺もそろそろ帰るか。カイル、今後ともよろしくな」
【フェイ】「アタシも今日はそろそろ店じまいにするか」	【フェイ】「アタシも今日はそろそろ店じまいにするか」
【ソル】「ずっとサボってただろ」	【ソル】「ずっとサボってただろ」
【フェイ】「セルフサービスみたいなもんだから、ウチ」	【フェイ】「セルフサービスみたいなもんだから、ウチ」
【フェイ】「あんたも今日は疲れただろ？ 部屋はさっきと同じで2階の一番奥の「つばめの部屋」な」	【フェイ】「あんたも今日は疲れただろ？ 部屋はさっきと同じで2階の一番奥の「つばめの部屋」な」
	
end	end
	
	
■フェードアウト	■フェードアウト
■フェードイン	■フェードイン
…………	…………
……	……
【フェイ】「アリス、そろそろ寝る時間」	【フェイ】「アリス、そろそろ寝る時間」
【アリス】「……はーい……」	【アリス】「……はーい……」
【ソル】「俺もそろそろ帰るか。カイル、今後ともよろしくな」	【ソル】「俺もそろそろ帰るか。カイル、今後ともよろしくな」
【フェイ】「アタシも今日はそろそろ店じまいにするか」	【フェイ】「アタシも今日はそろそろ店じまいにするか」
【ソル】「ずっとサボってただろ」	【ソル】「ずっとサボってただろ」
【フェイ】「セルフサービスみたいなもんだから、ウチ」	【フェイ】「セルフサービスみたいなもんだから、ウチ」
【フェイ】「あんたも今日は疲れただろ？ 部屋はさっきと同じで2階の一番奥の「つばめの部屋」な」	【フェイ】「あんたも今日は疲れただろ？ 部屋はさっきと同じで2階の一番奥の「つばめの部屋」な」
	
end	end